R 1000 700
NO ./textures/wolf/mossy.xpm
SO ./textures/wolf/purplestone.xpm
EA ./textures/wolf/colorstone.xpm
WE ./textures/wolf/greystone.xpm

C 115,194,251
S ./textures/wolf/barrel.xpm
F 167,166,157

1111111111111111111111111
1000000000000000100000001
1000000000000000100000001                                               
1000000002000W00100000001
1000000000000000100000001
1000000000000000100010201          
1000111111111111100010001
1000100000000000000011111
1000100000011110000000001
1000111111110010000020001
1000000000000011110000001
1000000111000000000000001
111111110000200011111111
1000000000000000000000001
1000111111111111111111111
1000100000000000000000001
1000100200111110000000111
1000100000100010000001
1000000001102000000000111
1000000001000000000000001
1111111111111111111111111
