R 800 600
NO ./textures/custom/botw.xpm
SO ./textures/custom/42.xpm
EA ./textures/custom/honeycombwall.xpm
WE ./textures/custom/circuit.xpm

C  70,48,140  
S ./textures/custom/murph.xpm
F  17,22,27


 11111111111111111111111
1000000000000000000000001
1000000000000000000000001
100000000000N000000000001
1000000000000000000000001
1000000000000000000000001
 11111111110001111111111 
1000000010000000100000001
101111101000000010111111                                               
1010201010002000101000001
1010000000000000101010001
1010111111111111100010001          
1010100000001000100011101
1011100200000010000000101
1010100000011111001000101
1010111111110001001000101
1000000000010201111111101
1010000111010000000000001
 11111110001001111111111
1000000000000000000000001
101111111111111111111111
1010000000000000000000001
1010201000111110110111101
1011111001100010010100101
1000001101002011011101101
1000000001000000000100001
 11111111 111111111 1111 
